PokerStars Game #14519394979:  Hold'em Limit ($0.02/$0.04) - 2008/01/13 - 00:22:15 (ET)
Table 'Merope' 10-max Seat #1 is the button
Seat 1: Player_1 ($0.75 in chips) 
Seat 3: Player_2 ($0.59 in chips) 
Seat 4: Player_3 ($1.47 in chips) 
Seat 6: Player_4 ($1.98 in chips) 
Seat 7: Player_5 ($1.22 in chips) 
Seat 8: Player_6 ($0.48 in chips) 
Seat 9: Player_7 ($1.39 in chips) 
Player_2: posts small blind $0.01
Player_3: posts big blind $0.02
*** HOLE CARDS ***
Dealt to Player_7 [Ts Jh]
Player_4: raises $0.02 to $0.04
Player_5: folds 
Player_6: folds 
Player_7: folds 
Player_1: calls $0.04
Player_2: calls $0.03
Player_3: folds 
*** FLOP *** [Qd Th Js]
Player_2: checks 
Player_4: bets $0.02
Player_1: calls $0.02
Player_2: calls $0.02
*** TURN *** [Qd Th Js] [2s]
Player_2: checks 
Player_4: bets $0.04
Player_1: calls $0.04
Player_2: calls $0.04
*** RIVER *** [Qd Th Js 2s] [7s]
Player_2: checks 
Player_4: bets $0.04
Player_1: folds 
Player_2: folds 
Player_4 collected $0.31 from pot
*** SUMMARY ***
Total pot $0.32 | Rake $0.01 
Board [Qd Th Js 2s 7s]
Seat 1: Player_1 (button) folded on the River
Seat 3: Player_2 (small blind) folded on the River
Seat 4: Player_3 (big blind) folded before Flop
Seat 6: Player_4 collected ($0.31)
Seat 7: Player_5 folded before Flop (didn't bet)
Seat 8: Player_6 folded before Flop (didn't bet)
Seat 9: Player_7 folded before Flop (didn't bet)



PokerStars Game #14519420999:  Hold'em Limit ($0.02/$0.04) - 2008/01/13 - 00:23:43 (ET)
Table 'Merope' 10-max Seat #4 is the button
Seat 1: Player_1 ($0.65 in chips) 
Seat 3: Player_2 ($0.49 in chips) 
Seat 4: Player_3 ($1.79 in chips) 
Seat 6: Player_4 ($2.05 in chips) 
Seat 7: Player_5 ($1.18 in chips) 
Seat 8: Player_6 ($0.34 in chips) 
Seat 9: Player_7 ($1.35 in chips) 
wakked13 will be allowed to play after the button
Player_4: posts small blind $0.01
Player_5: posts big blind $0.02
*** HOLE CARDS ***
Dealt to Player_7 [8d 5d]
Player_6 said, "vn"
Player_6: folds 
Player_7: folds 
Player_1: folds 
Player_2: calls $0.02
Player_3: folds 
Player_4: calls $0.01
Player_5: checks 
*** FLOP *** [Th Jd 3c]
Player_3 said, "ty"
Player_4: checks 
Player_5: bets $0.02
Player_2: calls $0.02
Player_4: calls $0.02
*** TURN *** [Th Jd 3c] [7c]
Player_4: checks 
Player_5: bets $0.04
Player_2: raises $0.04 to $0.08
Player_4: folds 
Player_5: calls $0.04
*** RIVER *** [Th Jd 3c 7c] [4s]
Player_5: checks 
Player_2: bets $0.04
Player_5: calls $0.04
*** SHOW DOWN ***
Player_2: shows [8s 9s] (a straight, Seven to Jack)
Player_5: mucks hand 
Player_2 collected $0.35 from pot
*** SUMMARY ***
Total pot $0.36 | Rake $0.01 
Board [Th Jd 3c 7c 4s]
Seat 1: Player_1 folded before Flop (didn't bet)
Seat 3: Player_2 showed [8s 9s] and won ($0.35) with a straight, Seven to Jack
Seat 4: Player_3 (button) folded before Flop (didn't bet)
Seat 6: Player_4 (small blind) folded on the Turn
Seat 7: Player_5 (big blind) mucked [Qh Js]
Seat 8: Player_6 folded before Flop (didn't bet)
Seat 9: Player_7 folded before Flop (didn't bet)



PokerStars Game #14519433154:  Hold'em Limit ($0.02/$0.04) - 2008/01/13 - 00:24:25 (ET)
Table 'Merope' 10-max Seat #6 is the button
Seat 1: Player_1 ($0.65 in chips) 
Seat 3: Player_2 ($0.68 in chips) 
Seat 4: Player_3 ($1.79 in chips) 
Seat 6: Player_4 ($2.01 in chips) 
Seat 7: Player_5 ($1.02 in chips) 
Seat 8: Player_6 ($0.34 in chips) 
Seat 9: Player_7 ($1.35 in chips) 
Player_5: posts small blind $0.01
Player_6: posts big blind $0.02
wakked13: sits out 
*** HOLE CARDS ***
Dealt to Player_7 [7c Jh]
Player_7: folds 
Player_1: folds 
Player_2: folds 
Player_3: calls $0.02
Player_4: calls $0.02
Player_5: raises $0.02 to $0.04
Player_6: calls $0.02
Player_3: calls $0.02
Player_4: calls $0.02
*** FLOP *** [4h 9s Ad]
Player_5: checks 
Player_6: checks 
Player_3: bets $0.02
Player_4: raises $0.02 to $0.04
Player_5: folds 
Player_6: folds 
Player_3: raises $0.02 to $0.06
Player_4: raises $0.02 to $0.08
Betting is capped
Player_3: calls $0.02
*** TURN *** [4h 9s Ad] [Qc]
Player_3: bets $0.04
Player_4: raises $0.04 to $0.08
Player_3: raises $0.04 to $0.12
Player_4: raises $0.04 to $0.16
Betting is capped
Player_3: calls $0.04
*** RIVER *** [4h 9s Ad Qc] [Ks]
Player_3: bets $0.04
Player_4: raises $0.04 to $0.08
Player_3: raises $0.04 to $0.12
Player_4: raises $0.04 to $0.16
Betting is capped
Player_3: calls $0.04
*** SHOW DOWN ***
Player_4: shows [Ac Td] (a pair of Aces)
Player_3: shows [Ah 9d] (two pair, Aces and Nines)
Player_3 collected $0.92 from pot
*** SUMMARY ***
Total pot $0.96 | Rake $0.04 
Board [4h 9s Ad Qc Ks]
Seat 1: Player_1 folded before Flop (didn't bet)
Seat 3: Player_2 folded before Flop (didn't bet)
Seat 4: Player_3 showed [Ah 9d] and won ($0.92) with two pair, Aces and Nines
Seat 6: Player_4 (button) showed [Ac Td] and lost with a pair of Aces
Seat 7: Player_5 (small blind) folded on the Flop
Seat 8: Player_6 (big blind) folded on the Flop
Seat 9: Player_7 folded before Flop (didn't bet)



